NO ./img/wall.png
SO      ./img/wall2.png   
C     225    ,30,     0
WE ./img/wall3.png
EA ./img/wall4.png


F 100,0,70

11111111111111111111111111111111111111111111111111111111111111111111111111111111111111
1000S000000001000000000000000000001
10000000000000000000000000011100001
1000000000000000000000000001 100001
10000000000001000000000000011100001
11111111111111111111111111111110111
                    100000000000001111
                    100000000000000001
                    100000000000000001
                    111111111111111111