1111111111111111111111111
1000000000000000000000001
1000000000000000000000001
1000000000000111000000001
1000000000000000020000001
1000000000000000000000001
1000000000000000000000001
1111111111111111111111111