NO ./img/wall.png
SO      ./img/wall2.png   
C     225    ,30,     0
             WE ./img/wall3.png
EA ./img/wall4.png                  


                   F 100,0                                            ,70

111111111111111111111111111111111111111111111111111111111111111111111111111111111111111                                                                                          
1E1
111